###########################
##                       ##
##                       ##
##                       ##
##         #####         ##
##         ## ##         ##
##         ## ##         ##
##                       ##
##                       ##
##                       ##
###########################